
R 1200 760

F 61,134,88

C 93,234,245
EA ./pics/wood.xpm
NO ./pics/bluestone.xpm
WE ./pics/redbrick.xpm
SO ./pics/stone.xpm
S ./pics/barrel.xpm


       1111111111111
     110000000000021
    1000002000000001
 1111111110000000001
         10000020001
         10000000001
         10000000001
         10000000001
         10000000001
         1002N000001
         10000000001
         10011100001
         10011000001
         10011100001
         10000000001
         10000000001
11111111110000000001111111111
10002000000000020000000000001
10000000000000000000000020001
11111111111111111111111111111