R 1200 760

F 33,20,40
C 227,170,250

EA ./pics/wood.xpm
SO ./pics/stone.xpm
NO ./pics/bluestone.xpm
WE ./pics/redbrick.xpm
S ./pics/barrel.xpm

111               1111111
1111111111111111  1111111  111
111111111111111   11   111111111111
1000002000111     10111111111    1
10200S0000111  1  10111111111    1
1000000000111     10111111111    1
1111020011111111111000001000111111
10010000200000000001111111111
111111111111111111000002100001
11000000001111    111011110201
111101111111111111000001000111111111
111101111111110111010100100011
110000001101010111000000100011
100020022200000011000000100011111111
100000000000000011010100111111
111000001101010111110111000001
10111011111111101101101110110111
111111111111 1111111111111111
10000000001   11111
11111111111   11111