R 1200 760

F 33,20,40
C 227,170,250

EA ./pics/wood.xpm
SO ./pics/stone.xpm
NO ./pics/bluestone.xpm
WE ./pics/redbrick.xpm    
S ./pics/barrel.xpm

1111111111111111
100000000000001
10000000000001
1000000000001
100000000001
10000000001
1000000001
100000001
1000N001
1000001
100001
10001
1001
101
11